##############################
#S         #   ##   # ### ####
# ###### # # #    # # ### ####
# #   ## #   # #### # ###   ##
#   # ##  ###    #  #  ## ####
##### #     # ##### ##    ####
#   # ##### #   #   # # #    #
# # #    ## # #### ## # # ####
# # # ##      ##      # # ####
# # # ####### ## ###### #   ##
# #   ##   ########### ###   #
# ###### # #####  #        # #
#        # #     ##### ### #  
# ######## ##### ##### ### ###
#     # ## ##### ###       ###
##### # ## #      ######## # #
#     # ## ## ###        #   #
# # ###       ###### ####### #
# #    ### ##      #         #
##############################
